11111111111111111111
1S000000000000000001
10111110111110111101
10100010100010100101
10101110101110101101
10100000100000100001
10111111111111111101
10000000000000000001
11111111111111111101
10000000000000000001
10111111111111111101
10100000000000000101
10101111111111110101
10100000000000000101
10111111111111111101
10000000000000000001
10111111111111111101
10000000000000000G01
10111111111111111101
11111111111111111111 