11111111111111111111
10000000000000000001
10111111111111111101
10100000000000000101
10101111111111110101
10101000000000010101
10101011111111010101
1010100S000001010101
10101011111101010101
10101010000001010101
10101010111101010101
10101010100001010101
10101010101111010101
10101010100000010101
10101010111111110101
10101010000000000101
10101011111111111101
1010100000000000G101
10111111111111111101
11111111111111111111 